fra;vaccin;jour;n_dose1;n_dose2;n_cum_dose1;n_cum_dose2
FR;1;2020-12-27;17;0;17;0
FR;1;2020-12-28;59;0;76;0
FR;1;2020-12-29;106;0;182;0
FR;1;2020-12-30;112;0;294;0
FR;1;2020-12-31;82;0;376;0
FR;1;2021-01-01;55;0;431;0
FR;1;2021-01-02;71;0;502;0
FR;1;2021-01-03;87;0;589;0
FR;1;2021-01-04;1461;0;2050;0
FR;1;2021-01-05;5332;0;7382;0
FR;1;2021-01-06;11235;0;18617;0
FR;1;2021-01-07;28427;0;47044;0
FR;1;2021-01-08;35844;0;82888;0
FR;1;2021-01-09;10862;0;93750;0
FR;1;2021-01-10;5599;0;99349;0
FR;1;2021-01-11;38665;0;138014;0
FR;1;2021-01-12;60068;0;198082;0
FR;1;2021-01-13;63127;0;261209;0
FR;1;2021-01-14;79103;0;340312;0
FR;1;2021-01-15;66534;0;406846;0
FR;1;2021-01-16;19372;657;426218;657
FR;1;2021-01-17;10427;40;436645;697
FR;1;2021-01-18;81051;187;517696;884
FR;1;2021-01-19;123126;224;640822;1108
FR;1;2021-01-20;129316;154;770138;1262
FR;1;2021-01-21;149157;152;919295;1414
FR;1;2021-01-22;112879;218;1032174;1632
FR;1;2021-01-23;35978;83;1068152;1715
FR;1;2021-01-24;9233;103;1077385;1818
FR;1;2021-01-25;72825;1493;1150210;3311
FR;1;2021-01-26;94470;3919;1244680;7230
FR;1;2021-01-27;101797;6788;1346477;14018
FR;1;2021-01-28;118063;17443;1464540;31461
FR;1;2021-01-29;87338;19590;1551878;51051
FR;1;2021-01-30;27529;4658;1579407;55709
FR;1;2021-01-31;4854;1905;1584261;57614
FR;1;2021-02-01;48020;24076;1632281;81690
FR;1;2021-02-02;65764;40496;1698045;122186
FR;1;2021-02-03;65549;41764;1763594;163950
FR;1;2021-02-04;75281;58422;1838875;222372
FR;1;2021-02-05;61999;49345;1900874;271717
FR;1;2021-02-06;19014;11342;1919888;283059
FR;1;2021-02-07;3427;6436;1923315;289495
FR;1;2021-02-08;35672;49830;1958987;339325
FR;1;2021-02-09;49649;81974;2008636;421299
FR;1;2021-02-10;50590;86708;2059226;508007
FR;1;2021-02-11;61661;109270;2120887;617277
FR;1;2021-02-12;54482;75138;2175369;692415
FR;1;2021-02-13;15082;18412;2190451;710827
FR;1;2021-02-14;3397;6745;2193848;717572
FR;1;2021-02-15;23444;71771;2217292;789343
FR;1;2021-02-16;31871;92098;2249163;881441
FR;1;2021-02-17;34191;102953;2283354;984394
FR;1;2021-02-18;47732;119857;2331086;1104251
FR;1;2021-02-19;44165;86062;2375251;1190313
FR;1;2021-02-20;12989;26112;2388240;1216425
FR;1;2021-02-21;2109;5291;2390349;1221716
FR;1;2021-02-22;23887;66822;2414236;1288538
FR;1;2021-02-23;36369;79755;2450605;1368293
FR;1;2021-02-24;39077;78743;2489682;1447036
FR;1;2021-02-25;48333;84786;2538015;1531822
FR;1;2021-02-26;45749;65564;2583764;1597386
FR;1;2021-02-27;15148;20965;2598912;1618351
FR;1;2021-02-28;3223;3566;2602135;1621917
FR;1;2021-03-01;38482;48527;2640617;1670444
FR;1;2021-03-02;54232;61371;2694849;1731815
FR;1;2021-03-03;58906;59118;2753755;1790933
FR;1;2021-03-04;70291;68557;2824046;1859490
FR;1;2021-03-05;72616;56815;2896662;1916305
FR;1;2021-03-06;81153;14991;2977815;1931296
FR;1;2021-03-07;62753;2337;3040568;1933633
FR;1;2021-03-08;58348;38340;3098916;1971973
FR;1;2021-03-09;83910;45205;3182826;2017178
FR;1;2021-03-10;88392;46256;3271218;2063434
FR;1;2021-03-11;102448;53381;3373666;2116815
FR;1;2021-03-12;101316;43295;3474982;2160110
FR;1;2021-03-13;87119;12072;3562101;2172182
FR;1;2021-03-14;43507;2092;3605608;2174274
FR;1;2021-03-15;93137;25776;3698745;2200050
FR;1;2021-03-16;120579;32173;3819324;2232223
FR;1;2021-03-17;125588;31691;3944912;2263914
FR;1;2021-03-18;138713;37360;4083625;2301274
FR;1;2021-03-19;132051;30099;4215676;2331373
FR;1;2021-03-20;73992;9211;4289668;2340584
FR;1;2021-03-21;25593;1340;4315261;2341924
FR;1;2021-03-22;111477;28395;4426738;2370319
FR;1;2021-03-23;138555;36306;4565293;2406625
FR;1;2021-03-24;137972;36819;4703265;2443444
FR;1;2021-03-25;159141;38526;4862406;2481970
FR;1;2021-03-26;161723;35765;5024129;2517735
FR;1;2021-03-27;108566;15089;5132695;2532824
FR;1;2021-03-28;41179;4553;5173874;2537377
FR;1;2021-03-29;125863;46945;5299737;2584322
FR;1;2021-03-30;161178;62363;5460915;2646685
FR;1;2021-03-31;164299;66814;5625214;2713499
FR;1;2021-04-01;183266;83842;5808480;2797341
FR;1;2021-04-02;158163;85272;5966643;2882613
FR;1;2021-04-03;85986;57305;6052629;2939918
FR;1;2021-04-04;32079;17457;6084708;2957375
FR;1;2021-04-05;42071;8997;6126779;2966372
FR;1;2021-04-06;147549;102621;6274328;3068993
FR;1;2021-04-07;186998;103176;6461326;3172169
FR;1;2021-04-08;208558;109274;6669884;3281443
FR;1;2021-04-09;199299;102527;6869183;3383970
FR;1;2021-04-10;114470;71264;6983653;3455234
FR;1;2021-04-11;39617;29135;7023270;3484369
FR;1;2021-04-12;158511;99141;7181781;3583510
FR;2;2020-12-27;0;0;0;0
FR;2;2020-12-28;0;0;0;0
FR;2;2020-12-29;0;0;0;0
FR;2;2020-12-30;0;0;0;0
FR;2;2020-12-31;0;0;0;0
FR;2;2021-01-01;0;0;0;0
FR;2;2021-01-02;0;0;0;0
FR;2;2021-01-03;0;0;0;0
FR;2;2021-01-04;0;0;0;0
FR;2;2021-01-05;0;0;0;0
FR;2;2021-01-06;0;0;0;0
FR;2;2021-01-07;0;0;0;0
FR;2;2021-01-08;0;0;0;0
FR;2;2021-01-09;0;0;0;0
FR;2;2021-01-10;0;0;0;0
FR;2;2021-01-11;0;0;0;0
FR;2;2021-01-12;0;0;0;0
FR;2;2021-01-13;0;0;0;0
FR;2;2021-01-14;140;0;140;0
FR;2;2021-01-15;218;0;358;0
FR;2;2021-01-16;185;0;543;0
FR;2;2021-01-17;3;0;546;0
FR;2;2021-01-18;2889;0;3435;0
FR;2;2021-01-19;4446;0;7881;0
FR;2;2021-01-20;4799;0;12680;0
FR;2;2021-01-21;5006;0;17686;0
FR;2;2021-01-22;4754;0;22440;0
FR;2;2021-01-23;1726;0;24166;0
FR;2;2021-01-24;81;0;24247;0
FR;2;2021-01-25;3580;0;27827;0
FR;2;2021-01-26;3589;0;31416;0
FR;2;2021-01-27;3399;0;34815;0
FR;2;2021-01-28;3479;0;38294;0
FR;2;2021-01-29;3073;0;41367;0
FR;2;2021-01-30;1053;0;42420;0
FR;2;2021-01-31;0;0;42420;0
FR;2;2021-02-01;3245;0;45665;0
FR;2;2021-02-02;4300;0;49965;0
FR;2;2021-02-03;5028;0;54993;0
FR;2;2021-02-04;4653;3;59646;3
FR;2;2021-02-05;4549;6;64195;9
FR;2;2021-02-06;1926;2;66121;11
FR;2;2021-02-07;28;0;66149;11
FR;2;2021-02-08;7407;11;73556;22
FR;2;2021-02-09;8245;15;81801;37
FR;2;2021-02-10;9124;50;90925;87
FR;2;2021-02-11;10042;121;100967;208
FR;2;2021-02-12;9750;256;110717;464
FR;2;2021-02-13;2995;205;113712;669
FR;2;2021-02-14;296;1;114008;670
FR;2;2021-02-15;3350;3106;117358;3776
FR;2;2021-02-16;4892;4166;122250;7942
FR;2;2021-02-17;4064;4465;126314;12407
FR;2;2021-02-18;5098;5103;131412;17510
FR;2;2021-02-19;5092;4424;136504;21934
FR;2;2021-02-20;1762;1498;138266;23432
FR;2;2021-02-21;197;86;138463;23518
FR;2;2021-02-22;3381;3724;141844;27242
FR;2;2021-02-23;4769;3602;146613;30844
FR;2;2021-02-24;4636;3517;151249;34361
FR;2;2021-02-25;5259;3400;156508;37761
FR;2;2021-02-26;4187;3095;160695;40856
FR;2;2021-02-27;1337;1054;162032;41910
FR;2;2021-02-28;99;3;162131;41913
FR;2;2021-03-01;4854;3720;166985;45633
FR;2;2021-03-02;6283;4644;173268;50277
FR;2;2021-03-03;6235;4916;179503;55193
FR;2;2021-03-04;8051;4135;187554;59328
FR;2;2021-03-05;7750;3907;195304;63235
FR;2;2021-03-06;4616;1661;199920;64896
FR;2;2021-03-07;2279;23;202199;64919
FR;2;2021-03-08;3964;8333;206163;73252
FR;2;2021-03-09;7244;8543;213407;81795
FR;2;2021-03-10;6818;9156;220225;90951
FR;2;2021-03-11;8963;9344;229188;100295
FR;2;2021-03-12;7671;8259;236859;108554
FR;2;2021-03-13;9822;2569;246681;111123
FR;2;2021-03-14;4740;344;251421;111467
FR;2;2021-03-15;10586;3408;262007;114875
FR;2;2021-03-16;16180;4715;278187;119590
FR;2;2021-03-17;19523;3969;297710;123559
FR;2;2021-03-18;22615;5011;320325;128570
FR;2;2021-03-19;22502;4626;342827;133196
FR;2;2021-03-20;24954;1593;367781;134789
FR;2;2021-03-21;17276;137;385057;134926
FR;2;2021-03-22;17129;3178;402186;138104
FR;2;2021-03-23;22055;4302;424241;142406
FR;2;2021-03-24;23284;4960;447525;147366
FR;2;2021-03-25;25853;5219;473378;152585
FR;2;2021-03-26;26136;4165;499514;156750
FR;2;2021-03-27;15360;1238;514874;157988
FR;2;2021-03-28;10071;145;524945;158133
FR;2;2021-03-29;18327;4161;543272;162294
FR;2;2021-03-30;23874;6050;567146;168344
FR;2;2021-03-31;27488;5799;594634;174143
FR;2;2021-04-01;32861;8401;627495;182544
FR;2;2021-04-02;28713;7662;656208;190206
FR;2;2021-04-03;16191;4273;672399;194479
FR;2;2021-04-04;8853;1197;681252;195676
FR;2;2021-04-05;11756;738;693008;196414
FR;2;2021-04-06;25201;7325;718209;203739
FR;2;2021-04-07;29809;6867;748018;210606
FR;2;2021-04-08;35337;8298;783355;218904
FR;2;2021-04-09;32663;8103;816018;227007
FR;2;2021-04-10;19333;8776;835351;235783
FR;2;2021-04-11;7767;4213;843118;239996
FR;2;2021-04-12;16097;10563;859215;250559
FR;3;2020-12-27;0;0;0;0
FR;3;2020-12-28;0;0;0;0
FR;3;2020-12-29;0;0;0;0
FR;3;2020-12-30;0;0;0;0
FR;3;2020-12-31;0;0;0;0
FR;3;2021-01-01;0;0;0;0
FR;3;2021-01-02;0;0;0;0
FR;3;2021-01-03;0;0;0;0
FR;3;2021-01-04;0;0;0;0
FR;3;2021-01-05;0;0;0;0
FR;3;2021-01-06;0;0;0;0
FR;3;2021-01-07;0;0;0;0
FR;3;2021-01-08;0;0;0;0
FR;3;2021-01-09;0;0;0;0
FR;3;2021-01-10;0;0;0;0
FR;3;2021-01-11;0;0;0;0
FR;3;2021-01-12;0;0;0;0
FR;3;2021-01-13;0;0;0;0
FR;3;2021-01-14;0;0;0;0
FR;3;2021-01-15;0;0;0;0
FR;3;2021-01-16;0;0;0;0
FR;3;2021-01-17;0;0;0;0
FR;3;2021-01-18;0;0;0;0
FR;3;2021-01-19;0;0;0;0
FR;3;2021-01-20;0;0;0;0
FR;3;2021-01-21;0;0;0;0
FR;3;2021-01-22;0;0;0;0
FR;3;2021-01-23;0;0;0;0
FR;3;2021-01-24;0;0;0;0
FR;3;2021-01-25;0;0;0;0
FR;3;2021-01-26;0;0;0;0
FR;3;2021-01-27;0;0;0;0
FR;3;2021-01-28;0;0;0;0
FR;3;2021-01-29;0;0;0;0
FR;3;2021-01-30;0;0;0;0
FR;3;2021-01-31;0;0;0;0
FR;3;2021-02-01;0;0;0;0
FR;3;2021-02-02;0;0;0;0
FR;3;2021-02-03;0;0;0;0
FR;3;2021-02-04;0;0;0;0
FR;3;2021-02-05;0;0;0;0
FR;3;2021-02-06;241;0;241;0
FR;3;2021-02-07;1355;0;1596;0
FR;3;2021-02-08;2590;0;4186;0
FR;3;2021-02-09;6540;0;10726;0
FR;3;2021-02-10;8985;0;19711;0
FR;3;2021-02-11;13054;0;32765;0
FR;3;2021-02-12;12751;0;45516;0
FR;3;2021-02-13;3452;0;48968;0
FR;3;2021-02-14;839;0;49807;0
FR;3;2021-02-15;9886;0;59693;0
FR;3;2021-02-16;11904;0;71597;0
FR;3;2021-02-17;10631;0;82228;0
FR;3;2021-02-18;14109;0;96337;0
FR;3;2021-02-19;13815;0;110152;0
FR;3;2021-02-20;3081;0;113233;0
FR;3;2021-02-21;530;0;113763;0
FR;3;2021-02-22;8671;0;122434;0
FR;3;2021-02-23;10829;0;133263;0
FR;3;2021-02-24;13527;0;146790;0
FR;3;2021-02-25;43552;0;190342;0
FR;3;2021-02-26;60385;0;250727;0
FR;3;2021-02-27;33904;8;284631;8
FR;3;2021-02-28;2277;0;286908;8
FR;3;2021-03-01;19282;28;306190;36
FR;3;2021-03-02;37616;12;343806;48
FR;3;2021-03-03;46722;21;390528;69
FR;3;2021-03-04;78886;26;469414;95
FR;3;2021-03-05;114699;70;584113;165
FR;3;2021-03-06;115957;55;700070;220
FR;3;2021-03-07;53561;30;753631;250
FR;3;2021-03-08;41143;25;794774;275
FR;3;2021-03-09;76575;38;871349;313
FR;3;2021-03-10;78328;45;949677;358
FR;3;2021-03-11;125067;59;1074744;417
FR;3;2021-03-12;178513;74;1253257;491
FR;3;2021-03-13;128507;53;1381764;544
FR;3;2021-03-14;13367;5;1395131;549
FR;3;2021-03-15;50381;42;1445512;591
FR;3;2021-03-16;828;9;1446340;600
FR;3;2021-03-17;542;5;1446882;605
FR;3;2021-03-18;1065;3;1447947;608
FR;3;2021-03-19;68529;42;1516476;650
FR;3;2021-03-20;63812;36;1580288;686
FR;3;2021-03-21;5431;5;1585719;691
FR;3;2021-03-22;36261;30;1621980;721
FR;3;2021-03-23;82756;51;1704736;772
FR;3;2021-03-24;89041;72;1793777;844
FR;3;2021-03-25;146960;122;1940737;966
FR;3;2021-03-26;162453;160;2103190;1126
FR;3;2021-03-27;66776;87;2169966;1213
FR;3;2021-03-28;6078;17;2176044;1230
FR;3;2021-03-29;52885;59;2228929;1289
FR;3;2021-03-30;91314;89;2320243;1378
FR;3;2021-03-31;61834;77;2382077;1455
FR;3;2021-04-01;83890;107;2465967;1562
FR;3;2021-04-02;85112;149;2551079;1711
FR;3;2021-04-03;34951;121;2586030;1832
FR;3;2021-04-04;3327;15;2589357;1847
FR;3;2021-04-05;4144;21;2593501;1868
FR;3;2021-04-06;28463;66;2621964;1934
FR;3;2021-04-07;31154;52;2653118;1986
FR;3;2021-04-08;76653;239;2729771;2225
FR;3;2021-04-09;157564;415;2887335;2640
FR;3;2021-04-10;73398;332;2960733;2972
FR;3;2021-04-11;6764;44;2967497;3016
FR;3;2021-04-12;48758;181;3016255;3197
FR;0;2020-12-27;17;0;17;0
FR;0;2020-12-28;59;0;76;0
FR;0;2020-12-29;106;0;182;0
FR;0;2020-12-30;112;0;294;0
FR;0;2020-12-31;82;0;376;0
FR;0;2021-01-01;55;0;431;0
FR;0;2021-01-02;71;0;502;0
FR;0;2021-01-03;87;0;589;0
FR;0;2021-01-04;1461;0;2050;0
FR;0;2021-01-05;5332;0;7382;0
FR;0;2021-01-06;11235;0;18617;0
FR;0;2021-01-07;28427;0;47044;0
FR;0;2021-01-08;35844;0;82888;0
FR;0;2021-01-09;10862;0;93750;0
FR;0;2021-01-10;5599;0;99349;0
FR;0;2021-01-11;38665;0;138014;0
FR;0;2021-01-12;60068;0;198082;0
FR;0;2021-01-13;63127;0;261209;0
FR;0;2021-01-14;79243;0;340452;0
FR;0;2021-01-15;66752;0;407204;0
FR;0;2021-01-16;19557;657;426761;657
FR;0;2021-01-17;10430;40;437191;697
FR;0;2021-01-18;83940;187;521131;884
FR;0;2021-01-19;127572;224;648703;1108
FR;0;2021-01-20;134115;154;782818;1262
FR;0;2021-01-21;154163;152;936981;1414
FR;0;2021-01-22;117633;218;1054614;1632
FR;0;2021-01-23;37704;83;1092318;1715
FR;0;2021-01-24;9314;103;1101632;1818
FR;0;2021-01-25;76405;1493;1178037;3311
FR;0;2021-01-26;98059;3919;1276096;7230
FR;0;2021-01-27;105196;6788;1381292;14018
FR;0;2021-01-28;121542;17443;1502834;31461
FR;0;2021-01-29;90411;19590;1593245;51051
FR;0;2021-01-30;28582;4658;1621827;55709
FR;0;2021-01-31;4854;1905;1626681;57614
FR;0;2021-02-01;51265;24076;1677946;81690
FR;0;2021-02-02;70064;40496;1748010;122186
FR;0;2021-02-03;70577;41764;1818587;163950
FR;0;2021-02-04;79934;58425;1898521;222375
FR;0;2021-02-05;66548;49351;1965069;271726
FR;0;2021-02-06;21181;11344;1986250;283070
FR;0;2021-02-07;4810;6436;1991060;289506
FR;0;2021-02-08;45669;49841;2036729;339347
FR;0;2021-02-09;64434;81989;2101163;421336
FR;0;2021-02-10;68699;86758;2169862;508094
FR;0;2021-02-11;84757;109391;2254619;617485
FR;0;2021-02-12;76983;75394;2331602;692879
FR;0;2021-02-13;21529;18617;2353131;711496
FR;0;2021-02-14;4532;6746;2357663;718242
FR;0;2021-02-15;36680;74877;2394343;793119
FR;0;2021-02-16;48667;96264;2443010;889383
FR;0;2021-02-17;48886;107418;2491896;996801
FR;0;2021-02-18;66939;124960;2558835;1121761
FR;0;2021-02-19;63072;90486;2621907;1212247
FR;0;2021-02-20;17832;27610;2639739;1239857
FR;0;2021-02-21;2836;5377;2642575;1245234
FR;0;2021-02-22;35939;70546;2678514;1315780
FR;0;2021-02-23;51967;83357;2730481;1399137
FR;0;2021-02-24;57240;82260;2787721;1481397
FR;0;2021-02-25;97144;88186;2884865;1569583
FR;0;2021-02-26;110321;68659;2995186;1638242
FR;0;2021-02-27;50389;22027;3045575;1660269
FR;0;2021-02-28;5599;3569;3051174;1663838
FR;0;2021-03-01;62618;52275;3113792;1716113
FR;0;2021-03-02;98131;66027;3211923;1782140
FR;0;2021-03-03;111863;64055;3323786;1846195
FR;0;2021-03-04;157228;72718;3481014;1918913
FR;0;2021-03-05;195065;60792;3676079;1979705
FR;0;2021-03-06;201726;16707;3877805;1996412
FR;0;2021-03-07;118593;2390;3996398;1998802
FR;0;2021-03-08;103455;46698;4099853;2045500
FR;0;2021-03-09;167729;53786;4267582;2099286
FR;0;2021-03-10;173538;55457;4441120;2154743
FR;0;2021-03-11;236478;62784;4677598;2217527
FR;0;2021-03-12;287500;51628;4965098;2269155
FR;0;2021-03-13;225448;14694;5190546;2283849
FR;0;2021-03-14;61614;2441;5252160;2286290
FR;0;2021-03-15;154104;29226;5406264;2315516
FR;0;2021-03-16;137587;36897;5543851;2352413
FR;0;2021-03-17;145653;35665;5689504;2388078
FR;0;2021-03-18;162393;42374;5851897;2430452
FR;0;2021-03-19;223082;34767;6074979;2465219
FR;0;2021-03-20;162758;10840;6237737;2476059
FR;0;2021-03-21;48300;1482;6286037;2477541
FR;0;2021-03-22;164867;31603;6450904;2509144
FR;0;2021-03-23;243366;40659;6694270;2549803
FR;0;2021-03-24;250297;41851;6944567;2591654
FR;0;2021-03-25;331954;43867;7276521;2635521
FR;0;2021-03-26;350312;40090;7626833;2675611
FR;0;2021-03-27;190702;16414;7817535;2692025
FR;0;2021-03-28;57328;4715;7874863;2696740
FR;0;2021-03-29;197075;51165;8071938;2747905
FR;0;2021-03-30;276366;68502;8348304;2816407
FR;0;2021-03-31;253621;72690;8601925;2889097
FR;0;2021-04-01;300017;92350;8901942;2981447
FR;0;2021-04-02;271988;93083;9173930;3074530
FR;0;2021-04-03;137128;61699;9311058;3136229
FR;0;2021-04-04;44259;18669;9355317;3154898
FR;0;2021-04-05;57971;9756;9413288;3164654
FR;0;2021-04-06;201213;110012;9614501;3274666
FR;0;2021-04-07;247961;110095;9862462;3384761
FR;0;2021-04-08;320548;117811;10183010;3502572
FR;0;2021-04-09;389526;111045;10572536;3613617
FR;0;2021-04-10;207201;80372;10779737;3693989
FR;0;2021-04-11;54148;33392;10833885;3727381
FR;0;2021-04-12;223366;109885;11057251;3837266
