fra;vaccin;jour;n_dose1;n_dose2;n_cum_dose1;n_cum_dose2
FR;1;2020-12-27;14;0;14;0
FR;1;2020-12-28;42;0;56;0
FR;1;2020-12-29;104;0;160;0
FR;1;2020-12-30;106;0;266;0
FR;1;2020-12-31;80;0;346;0
FR;1;2021-01-01;44;0;390;0
FR;1;2021-01-02;67;0;457;0
FR;1;2021-01-03;84;0;541;0
FR;1;2021-01-04;1433;0;1974;0
FR;1;2021-01-05;5294;0;7268;0
FR;1;2021-01-06;11040;0;18308;0
FR;1;2021-01-07;27923;0;46231;0
FR;1;2021-01-08;35314;0;81545;0
FR;1;2021-01-09;10819;0;92364;0
FR;1;2021-01-10;5576;0;97940;0
FR;1;2021-01-11;38020;0;135960;0
FR;1;2021-01-12;59058;0;195018;0
FR;1;2021-01-13;62175;0;257193;0
FR;1;2021-01-14;77378;0;334571;0
FR;1;2021-01-15;65377;52;399948;52
FR;1;2021-01-16;19299;627;419247;679
FR;1;2021-01-17;10412;8;429659;687
FR;1;2021-01-18;80231;43;509890;730
FR;1;2021-01-19;122163;107;632053;837
FR;1;2021-01-20;128145;62;760198;899
FR;1;2021-01-21;147338;71;907536;970
FR;1;2021-01-22;111699;123;1019235;1093
FR;1;2021-01-23;35814;56;1055049;1149
FR;1;2021-01-24;9152;91;1064201;1240
FR;1;2021-01-25;72421;1378;1136622;2618
FR;1;2021-01-26;93334;3755;1229956;6373
FR;1;2021-01-27;100368;6595;1330324;12968
FR;1;2021-01-28;116587;16889;1446911;29857
FR;1;2021-01-29;86401;18936;1533312;48793
FR;1;2021-01-30;27378;4579;1560690;53372
FR;1;2021-01-31;4837;1875;1565527;55247
FR;1;2021-02-01;47603;23350;1613130;78597
FR;1;2021-02-02;64439;39367;1677569;117964
FR;1;2021-02-03;64889;40462;1742458;158426
FR;1;2021-02-04;73799;56078;1816257;214504
FR;1;2021-02-05;61063;47424;1877320;261928
FR;1;2021-02-06;18589;11127;1895909;273055
FR;1;2021-02-07;3374;6358;1899283;279413
FR;1;2021-02-08;35108;48249;1934391;327662
FR;1;2021-02-09;48543;79065;1982934;406727
FR;1;2021-02-10;49263;84013;2032197;490740
FR;1;2021-02-11;59215;104603;2091412;595343
FR;1;2021-02-12;52745;72390;2144157;667733
FR;1;2021-02-13;14746;17992;2158903;685725
FR;1;2021-02-14;3356;6562;2162259;692287
FR;1;2021-02-15;22800;69667;2185059;761954
FR;1;2021-02-16;30956;89141;2216015;851095
FR;1;2021-02-17;33070;98595;2249085;949690
FR;1;2021-02-18;45398;114436;2294483;1064126
FR;1;2021-02-19;42289;82032;2336772;1146158
FR;1;2021-02-20;12569;24825;2349341;1170983
FR;1;2021-02-21;2005;5049;2351346;1176032
FR;1;2021-02-22;23111;64515;2374457;1240547
FR;1;2021-02-23;34438;76567;2408895;1317114
FR;1;2021-02-24;36910;75423;2445805;1392537
FR;1;2021-02-25;45429;80826;2491234;1473363
FR;1;2021-02-26;42670;62298;2533904;1535661
FR;1;2021-02-27;14448;20175;2548352;1555836
FR;1;2021-02-28;3097;3369;2551449;1559205
FR;1;2021-03-01;35746;45997;2587195;1605202
FR;1;2021-03-02;50720;57002;2637915;1662204
FR;1;2021-03-03;55083;54505;2692998;1716709
FR;0;2020-12-27;15;0;15;0
FR;0;2020-12-28;42;0;57;0
FR;0;2020-12-29;104;0;161;0
FR;0;2020-12-30;106;0;267;0
FR;0;2020-12-31;80;0;347;0
FR;0;2021-01-01;44;0;391;0
FR;0;2021-01-02;67;0;458;0
FR;0;2021-01-03;84;0;542;0
FR;0;2021-01-04;1433;0;1975;0
FR;0;2021-01-05;5294;0;7269;0
FR;0;2021-01-06;11040;0;18309;0
FR;0;2021-01-07;27923;0;46232;0
FR;0;2021-01-08;35314;0;81546;0
FR;0;2021-01-09;10819;0;92365;0
FR;0;2021-01-10;5576;0;97941;0
FR;0;2021-01-11;38020;0;135961;0
FR;0;2021-01-12;59058;0;195019;0
FR;0;2021-01-13;62181;0;257200;0
FR;0;2021-01-14;77502;0;334702;0
FR;0;2021-01-15;65596;52;400298;52
FR;0;2021-01-16;19484;627;419782;679
FR;0;2021-01-17;10415;8;430197;687
FR;0;2021-01-18;83077;43;513274;730
FR;0;2021-01-19;126539;107;639813;837
FR;0;2021-01-20;132926;62;772739;899
FR;0;2021-01-21;152340;71;925079;970
FR;0;2021-01-22;116453;123;1041532;1093
FR;0;2021-01-23;37539;56;1079071;1149
FR;0;2021-01-24;9233;91;1088304;1240
FR;0;2021-01-25;75999;1378;1164303;2618
FR;0;2021-01-26;96923;3755;1261226;6373
FR;0;2021-01-27;103766;6595;1364992;12968
FR;0;2021-01-28;120065;16890;1485057;29858
FR;0;2021-01-29;89473;18936;1574530;48794
FR;0;2021-01-30;28430;4579;1602960;53373
FR;0;2021-01-31;4837;1875;1607797;55248
FR;0;2021-02-01;50847;23350;1658644;78598
FR;0;2021-02-02;68730;39367;1727374;117965
FR;0;2021-02-03;69905;40463;1797279;158428
FR;0;2021-02-04;78443;56080;1875722;214508
FR;0;2021-02-05;65582;47426;1941304;261934
FR;0;2021-02-06;20637;11127;1961941;273061
FR;0;2021-02-07;4751;6358;1966692;279419
FR;0;2021-02-08;44966;48255;2011658;327674
FR;0;2021-02-09;63087;79075;2074745;406749
FR;0;2021-02-10;67179;84056;2141924;490805
FR;0;2021-02-11;81573;104717;2223497;595522
FR;0;2021-02-12;74791;72635;2298288;668157
FR;0;2021-02-13;21141;18194;2319429;686351
FR;0;2021-02-14;4497;6562;2323926;692913
FR;0;2021-02-15;35645;72670;2359571;765583
FR;0;2021-02-16;47310;93178;2406881;858761
FR;0;2021-02-17;47343;103024;2454224;961785
FR;0;2021-02-18;63922;119503;2518146;1081288
FR;0;2021-02-19;60405;86432;2578551;1167720
FR;0;2021-02-20;17239;26316;2595790;1194036
FR;0;2021-02-21;2726;5135;2598516;1199171
FR;0;2021-02-22;34561;68204;2633077;1267375
FR;0;2021-02-23;49236;80161;2682313;1347536
FR;0;2021-02-24;53957;78873;2736270;1426409
FR;0;2021-02-25;92813;84215;2829083;1510624
FR;0;2021-02-26;105567;65378;2934650;1576002
FR;0;2021-02-27;49006;21227;2983656;1597229
FR;0;2021-02-28;5304;3372;2988960;1600601
FR;0;2021-03-01;58523;49666;3047483;1650267
FR;0;2021-03-02;92552;61640;3140035;1711907
FR;0;2021-03-03;105482;59339;3245517;1771246
FR;2;2021-01-13;6;0;6;0
FR;2;2021-01-14;124;0;130;0
FR;2;2021-01-15;218;0;348;0
FR;2;2021-01-16;185;0;533;0
FR;2;2021-01-17;3;0;536;0
FR;2;2021-01-18;2846;0;3382;0
FR;2;2021-01-19;4376;0;7758;0
FR;2;2021-01-20;4781;0;12539;0
FR;2;2021-01-21;5002;0;17541;0
FR;2;2021-01-22;4752;0;22293;0
FR;2;2021-01-23;1725;0;24018;0
FR;2;2021-01-24;81;0;24099;0
FR;2;2021-01-25;3577;0;27676;0
FR;2;2021-01-26;3589;0;31265;0
FR;2;2021-01-27;3397;0;34662;0
FR;2;2021-01-28;3478;1;38140;1
FR;2;2021-01-29;3072;0;41212;1
FR;2;2021-01-30;1052;0;42264;1
FR;2;2021-02-01;3244;0;45508;1
FR;2;2021-02-02;4291;0;49799;1
FR;2;2021-02-03;5015;1;54814;2
FR;2;2021-02-04;4644;2;59458;4
FR;2;2021-02-05;4515;2;63973;6
FR;2;2021-02-06;1851;0;65824;6
FR;2;2021-02-07;26;0;65850;6
FR;2;2021-02-08;7314;6;73164;12
FR;2;2021-02-09;8112;10;81276;22
FR;2;2021-02-10;9044;43;90320;65
FR;2;2021-02-11;9859;114;100179;179
FR;2;2021-02-12;9622;245;109801;424
FR;2;2021-02-13;2950;202;112751;626
FR;2;2021-02-14;305;0;113056;626
FR;2;2021-02-15;3289;3003;116345;3629
FR;2;2021-02-16;4786;4037;121131;7666
FR;2;2021-02-17;3999;4429;125130;12095
FR;2;2021-02-18;5000;5067;130130;17162
FR;2;2021-02-19;4812;4399;134942;21561
FR;2;2021-02-20;1755;1491;136697;23052
FR;2;2021-02-21;193;86;136890;23138
FR;2;2021-02-22;3139;3688;140029;26826
FR;2;2021-02-23;4476;3594;144505;30420
FR;2;2021-02-24;4183;3448;148688;33868
FR;2;2021-02-25;5021;3389;153709;37257
FR;2;2021-02-26;3987;3077;157696;40334
FR;2;2021-02-27;1327;1052;159023;41386
FR;2;2021-02-28;97;3;159120;41389
FR;2;2021-03-01;4412;3667;163532;45056
FR;2;2021-03-02;5886;4638;169418;49694
FR;2;2021-03-03;5974;4833;175392;54527
FR;3;2021-02-06;197;0;197;0
FR;3;2021-02-07;1351;0;1548;0
FR;3;2021-02-08;2544;0;4092;0
FR;3;2021-02-09;6432;0;10524;0
FR;3;2021-02-10;8872;0;19396;0
FR;3;2021-02-11;12499;0;31895;0
FR;3;2021-02-12;12424;0;44319;0
FR;3;2021-02-13;3445;0;47764;0
FR;3;2021-02-14;836;0;48600;0
FR;3;2021-02-15;9556;0;58156;0
FR;3;2021-02-16;11568;0;69724;0
FR;3;2021-02-17;10274;0;79998;0
FR;3;2021-02-18;13524;0;93522;0
FR;3;2021-02-19;13304;0;106826;0
FR;3;2021-02-20;2915;0;109741;0
FR;3;2021-02-21;528;0;110269;0
FR;3;2021-02-22;8311;0;118580;0
FR;3;2021-02-23;10322;0;128902;0
FR;3;2021-02-24;12864;0;141766;0
FR;3;2021-02-25;42363;0;184129;0
FR;3;2021-02-26;58910;0;243039;0
FR;3;2021-02-27;33231;0;276270;0
FR;3;2021-02-28;2110;0;278380;0
FR;3;2021-03-01;18365;0;296745;0
FR;3;2021-03-02;35946;0;332691;0
FR;3;2021-03-03;44425;0;377116;0
